屋	ㄨ
房	ㄈㄤˊ
東	ㄉㄨㄥ
楊	ㄧㄤˊ
勝	ㄕㄥˋ
栗	ㄌㄧˋ
苗	ㄇㄧㄠˊ
利	ㄌㄧˋ
交	ㄐㄧㄠ
通	ㄊㄨㄥ
流	ㄌㄧㄡˊ
道	ㄉㄠˋ
居	ㄐㄩ
留	ㄌㄧㄡˊ
證	ㄓㄥˋ
鄰	ㄌㄧㄣˊ
原	ㄩㄢˊ
全	ㄑㄩㄢˊ
前	ㄑㄧㄢˊ
造	ㄗㄠˋ
橋	ㄑㄧㄠˊ
紫	ㄗˇ
紹	ㄕㄠˋ
順	ㄕㄨㄣˋ 
苑	ㄩㄢˋ
崇	ㄔㄨㄥˊ 
力	ㄌㄧˋ
立	ㄌㄧˋ
擱	ㄍㄜ
巧	ㄑㄧㄠˇ
柔	ㄖㄡˊ
禹	ㄩˇ
聖	ㄕㄥˋ
請	ㄑㄧㄥˇ
局	ㄐㄩˊ
幫	ㄅㄤ
宗	ㄗㄨㄥ
成	ㄔㄥˊ
寫	ㄒㄧㄝˇ
亂	ㄌㄨㄢˋ
軟	ㄖㄨㄢˇ
件	ㄐㄧㄢˋ
站	ㄓㄢˋ
店	ㄉㄧㄢˋ
思	ㄙ
兆	ㄓㄠˋ
侯	ㄏㄡˊ
猴	ㄏㄡˊ
郵	ㄧㄡˊ
區	ㄑㄩ
豐	ㄈㄥ

